████▄███████▄███▄███████▄█████▌
S   █       █   █       █     █
▐█▌ ▐███▌ ▄ █ ▄ ▐█▌ ▐█▌ ▐█▌ ▄ █
█ █ █     █ █ █     █ █   █ █ █
█ ▀ █ ▐█▄█▌ █ ▐█▄███▌ ▐█▌ ▐█▌ █
█   █   █   █   █     █   █   █
█ ▐█▀█▌ █ ▐█▀█▌ ▐█▌ ▐█▌ ▐█▌ ▄ █
█ █     █ █     █   █   █   █ █
█ █ ▄ ▐█▌ █ ▐███▌ ▐█▌ ▐█▌ ▄ █ █
█ █ █ █   █ █     █   █   █ █ █
█ ▐█▌ █ ▐█▌ █ ▐█▌ █ ▐█▀█▌ █ ▐█▌
█     █   █ █ █   █     █ █   █
▐█████▀█▌ ▀ █ █ ▄ ▐███▌ █ ▐█▌ █
█       █   █ █ █ █     █   █ █
▐███▌ ▄ ▐███▌ █ ▐█▌ ▐█▄█▌ ▐█▌ █
█     █ █   █ █ █   █ █   █   █
█ ▐█▄█▌ ▐█▌ █ █ ▀ ▐█▌ ▀ ▐█▌ ▐█▌
█   █ █ █   █ █   █     █ █   █
▐█▌ █ ▀ ▀ ▄ █ ▐█▄█▌ ▐███▌ ▐█▌ █
█   █     █ █   █ █         █ █
█ ▐█▀███▌ ▐█▀█▌ █ ▐███▌ ▐███▌ █
█ █     █ █     █       █     █
█ ▀ ▐█▌ █ █ ▐███▀███████▌ ▐█▌ █
█     █ █ █ █             █ █ █
█ ▐███▌ █ █ █ ▐█▌ ▐███████▌ ▀ █
█ █     █ █ █   █ █           █
█ █ ▐█▌ ▐█▌ ▐███▌ █ ▐███████▄█▌
█ █   █ █   █     █ █       █ █
█ ▐█▌ ▐█▌ ▐█▌ ▐███▌ ▐███▌ ▄ ▀ █
█   █         █           █   E
▐███▀█████████▀███████████▀████