██████▄███████████████▄███████▌
S     █               █       █
▐███▌ ▐█████▄█▌ ▐███▌ █ ▐█▌ ▐█▌
█   █       █   █   █ █   █   █
█ ▐█▀█████▌ ▀ ▐█▌ ▄ ▀ ▐█▌ ▐█▌ █
█         █   █ █ █   █ █ █   █
█ ▐█████▌ ▐█▄█▌ ▀ ▐███▌ █ █ ▐█▌
█       █   █ █   █   █ █ █   █
▐███▌ ▐█▌ ▄ ▀ █ ▐█▌ ▄ █ █ ▐█▌ █
█     █   █   █     █ █ █ █   █
█ ▐███▌ ▄ ▐███▀█████▌ █ ▀ █ ▄ █
█ █   █ █ █         █ █   █ █ █
█ █ ▄ ▀ █ █         █ ▐█▌ █ ▐█▌
█ █ █   █ █         █   █ █   █
█ █ ▐███▀█▌         ▐█▌ ▐███▌ █
█ █       █         █ █   █   █
█ ▐█▄█▄█▌ █         █ ▐█▌ █ ▐█▌
█   █ █   █         █   █ █   █
▐█▌ █ █ ▐█▌         ▐█▌ █ ▐█▌ █
█   █ █   █         █   █     █
█ ▐█▌ ▐█▌ ▐███████▄█▌ ▐█▀███▌ █
█   █   █         █         █ █
▐█▌ ▐█▌ ▐███▌ ▐█▌ █ ▐█▄███▌ █ █
█   █       █ █   █   █     █ █
█ ▐█▌ ▐█████▌ ▐█▌ ▐███▌ ▐███▌ █
█   █       █   █       █     █
▐█▌ ▐███▌ ▄ ▐█▌ ▐█▄███▄█▌ ▐███▌
█ █     █ █   █   █   █   █   █
█ ▐███▌ ▐█▌ ▄ ▐█▌ ▀ ▄ ▀ ▐█▌ ▄ █
█           █   █   █       █ E
▐███████████▀███▀███▀███████▀██