██████████▄███████████▄███████▌
S         █           █       █
▐███████▌ ▐█▌ ▐█▌ ▐█▌ █ ▐███▌ █
█       █   █ █ █   █ █ █     █
█ ▐███▌ ▐█▌ █ ▀ ▐█▌ █ █ ▐█████▌
█     █   █ █   █   █ █       █
▐█▄█▌ ▐█▌ █ ▐███▌ ▐█▌ ▐█▌ ▐█▌ █
█ █   █ █ █       █ █   █ █   █
█ ▀ ▐█▌ █ ▐███████▌ ▐█▌ ▐█▌ ▄ █
█   █   █             █ █   █ █
█ ▐█▀█▌ ▐█▄█████████▌ █ █ ▐█▌ █
█ █     █ █         █ █ █ █   █
█ █ ▄ ▄ ▀ █         █ ▀ █ ▐███▌
█ █ █ █   █         █   █     █
█ ▐█▌ ▐█▌ █         ▐███▌ ▐█▌ █
█     █ █ █         █   █ █   █
▐█▄███▌ ▀ █         █ ▐█▌ █ ▄ █
█ █       █         █     █ █ █
█ █ ▐█▄███▌         █ ▐███▌ █ █
█ █   █   █         █ █     █ █
█ ▐█▌ ▐█▌ ▐███▄█████▌ █ ▐█▄█▌ █
█   █     █   █     █ █ █ █   █
█ ▄ ▐█▄█▌ █ ▄ ▐█▌ ▄ ▐█▌ █ ▀ ▐█▌
█ █   █   █ █ █   █ █   █   █ █
█ █ ▄ █ ▐█▌ █ ▀ ▐█▌ █ ▐█▌ ▐█▌ █
█ █ █ █   █ █   █   █ █   █   █
▐█▌ ▐█▀█▌ █ ▐███▌ ▐█▌ █ ▐█▀█▌ █
█   █     █     █   █ █ █     █
█ ▐█▌ ▐███▀███▌ ▐█▌ ▀ █ ▀ ▐█▌ █
█               █     █   █   E
▐███████████████▀█████▀███▀████