██▄█████████▄█████▄███████▄███▌
S █         █     █       █   █
█ █ ▐█▌ ▐███▌ ▐█▌ █ ▐███▌ ▀ ▄ █
█ █   █         █ █     █   █ █
█ ▐█▌ ▐█████████▌ ▐█▌ ▐█▀█▌ █ █
█   █ █             █ █   █ █ █
▐█▌ ▐█▌ ▐███▄█████▌ █ █ ▄ ▐█▌ █
█ █   █ █   █     █ █ █ █     █
█ ▐█▌ █ █ ▄ ▀ ▐█▌ ▐█▌ █ ▐█▄█▌ █
█ █   █ █ █     █     █   █   █
█ ▀ ▐█▌ █ ▐█████▀███▌ ▐█▌ █ ▐█▌
█   █   █ █         █ █   █   █
█ ▐█▌ ▄ ▀ █         █ █ ▐█▀█▌ █
█ █   █   █         █ █ █   █ █
█ ▐███▀███▌         █ █ ▐█▌ █ █
█ █       █         █ █   █ █ █
█ ▀ ▐███▌ █         █ ▐█▌ █ █ █
█   █     █         █ █   █ █ █
▐█▄█▌ ▐███▌         █ █ ▐█▌ ▀ █
█ █   █   █         █ █   █   █
█ █ ▐█▀█▌ ▐█▄███████▌ ▐█▌ ▐█▌ █
█ █         █       █   █   █ █
█ ▐███████▌ ▐█▌ ▄ ▐█▀█▌ ▐█▌ █ █
█         █   █ █     █   █ █ █
█ ▐█▌ ▐█▌ ▐█▌ ▐█▀█▌ ▄ ▐█▌ █ ▐█▌
█ █   █     █     █ █     █   █
█ █ ▄ ▐███▄█▀█▄█▌ █ ▐█▄███▀█▌ █
█ █ █ █   █   █   █   █       █
█ █ ▐█▌ ▄ ▀ ▄ ▀ ▐█▀███▌ ▐███▌ █
█ █     █   █           █     E
▐█▀█████▀███▀███████████▀██████