██▄███████████████▄█████████▄█▌
S █               █         █ █
█ ▐███▌ ▐███▄███▌ █ ▐█████▌ █ █
█     █ █   █   █ █ █     █ █ █
▐███▌ █ ▀ ▄ █ ▐█▌ ▀ █ ▐█▌ █ █ █
█     █   █ █   █   █   █ █ █ █
█ ▐█▄█▌ ▐█▌ █ ▄ ▐███▌ ▄ █ █ ▀ █
█ █ █   █   █ █       █ █ █   █
█ █ ▀ ▐█▌ ▐█▌ ▐█████▄█▌ █ ▐█▌ █
█ █     █ █         █   █ █   █
█ ▐█▄███▌ ▐█████████▌ ▐█▀█▌ ▐█▌
█   █     █         █       █ █
▐█▌ █ ▐███▌         █ ▐█▄███▌ █
█   █ █   █         █   █   █ █
█ ▐█▌ █ ▐█▌         ▐█▌ ▀ ▄ ▀ █
█     █   █         █ █   █   █
▐█████▀█▌ █         █ ▐█▄█▀█▌ █
█       █ █         █   █     █
█ ▐█▌ ▄ ▀ █         ▐█▌ █ ▐█▄█▌
█   █ █   █         █   █   █ █
█ ▐█▌ ▐███▀███▄█████▌ ▄ ▐█▌ ▀ █
█ █   █       █       █   █   █
█ █ ▄ █ ▐█▄█▌ █ ▄ ▐███████▀█▌ █
█ █ █ █   █ █ █ █     █     █ █
▐█▌ ▐█▀█▌ ▀ █ █ ▐███▌ ▀ ▄ ▐█▌ █
█   █       █ █     █   █   █ █
█ ▐█▌ ▐█▄███▌ ▐███▌ ▐█████▌ ▀ █
█   █   █         █     █ █   █
█ ▄ ▐█▌ █ ▐███████▀███▌ ▀ ▐███▌
█ █     █                     E
▐█▀█████▀██████████████████████